1111111111111
1000C00C000C1
1000C00C000C1
1000C0EC000C1
1000C00C000C1
1000C00C000C1
1000C0PC000C1
1111111111111