1111111111111111111111111111
1E000C0000C0000C0000C0000001
1010010100100000101010000001
1010010C10101010001010000001
101001C010101010001010000001
1010010C10101010001010000001
1010010010101010001010000001
1P0000000C00C0000000000000C1
100000000C00C0000000000000C1
1000001100001000000100C1C001
1000001100001000000100C1C001
111111C111111111000001101011
111111CC00000000000CCCC00001
111111CC00000000000CCCC00001
1111111111111111111111111111