111111111111111111111111111
100000000000000000000000001
10000C111C00000C111C0000001
100001000100000100010000001
100001000100E00100010000001
10000C111C00000C111C0000001
100000000001100000000000001
100CC00000011000000000CC001
100CC0000000C000000000CC001
100000111111111111111000001
100000101010101010101000001
100000111111111111111000P01
1000000000CCCCC000000000001
111111111111111111111111111